Script started on Wed Sep  7 17:48:58 2022

The default interactive shell is now zsh.
To update your account to use zsh, please run `chsh -s /bin/zsh`.
For more details, please visit https://support.apple.com/kb/HT208050.
[?1034hbash-3.2$ ls
Applications		Documents		Library			Music			Public			WorldyHello.txt		typescript
Desktop			Downloads		Movies			Pictures		WorldlyHello.cpp	a.out
bash-3.2$ cd Documents/
bash-3.2$ ls
EmploymentRenewal.pdf				EmploymentRenewalSept.pdf			EmploymentRenwalNov.pdf
EmploymentRenewalLetter(AUG).pdf		EmploymentRenewalSigned.pdf			employmentRenewalOctober(DevlinMckenna).pdf
bash-3.2$ mkdir CISC_3142
bash-3.2$ ls
CISC_3142					EmploymentRenewalSept.pdf			employmentRenewalOctober(DevlinMckenna).pdf
EmploymentRenewal.pdf				EmploymentRenewalSigned.pdf
EmploymentRenewalLetter(AUG).pdf		EmploymentRenwalNov.pdf
bash-3.2$ cd CISC_3142/
bash-3.2$ ls
bash-3.2$ mkdir Labs/Assignments[C[C[C[C[C[C[C[C[C[C[C
mkdir: Labs: No such file or directory
bash-3.2$ mkdir Labs_Assignments
bash-3.2$ mkdir Labs_Assignments/Assignments[C[C[C[C[C[C[C[C[C[Cls[Kcd CISC_3142/[C[C[C[C[C[C[C[C[C[Cls[Kmkdir CISC_3142[C[C[C[C[C[C[C[C[C[Cls[Kcd Documents/[C[C[C[C[C[C[C[C[C[Cls[Kcd Documents/[C[C[C[C[C[C[C[C[C[Cls[Kmkdir CISC_3142[C[C[C[C[C[C[C[C[C[Cls[Kcd CISC_3142/[C[C[C[C[C[C[C[C[C[Cls[Kmkdir Labs/Assignments_Assignments[C[C[C[C[C[C[C[C[C[C[Kvim WordlyGreetings.cpp
[?1000h[?1049h[22;0;0t[>4;2m[?1h=[?2004h[?1004h[1;56r[?12h[?12l[22;2t[22;1t[27m[23m[29m[m[H[2J[?25l[56;1H"WordlyGreetings.cpp" [New][2;1H▽[6n[2;1H  [3;1HPzz\[0%m[6n[3;1H           [1;1H[>c]10;?]11;?[2;1H[94m~                                                                                                                                                                                    [3;1H~                                                                                                                                                                                    [4;1H~                                                                                                                                                                                    [5;1H~                                                                                                                                                                                    [6;1H~                                                                                                                                                                                    [7;1H~                                                                                                                                                                                    [8;1H~                                                                                                                                                                                    [9;1H~                                                                                                                                                                                    [10;1H~                                                                                                                                                                                    [11;1H~                                                                                                                                                                                    [12;1H~                                                                                                                                                                                    [13;1H~                                                                                                                                                                                    [14;1H~                                                                                                                                                                                    [15;1H~                                                                                                                                                                                    [16;1H~                                                                                                                                                                                    [17;1H~                                                                                                                                                                                    [18;1H~                                                                                                                                                                                    [19;1H~                                                                                                                                                                                    [20;1H~                                                                                                                                                                                    [21;1H~                                                                                                                                                                                    [22;1H~                                                                                                                                                                                    [23;1H~                                                                                                                                                                                    [24;1H~                                                                                                                                                                                    [25;1H~                                                                                                                                                                                    [26;1H~                                                                                                                                                                                    [27;1H~                                                                                                                                                                                    [28;1H~                                                                                                                                                                                    [29;1H~                                                                                                                                                                                    [30;1H~                                                                                                                                                                                    [31;1H~                                                                                                                                                                                    [32;1H~                                                                                                                                                                                    [33;1H~                                                                                                                                                                                    [34;1H~                                                                                                                                                                                    [35;1H~                                                                                                                                                                                    [36;1H~                                                                                                                                                                                    [37;1H~                                                                                                                                                                                    [38;1H~                                                                                                                                                                                    [39;1H~                                                                                                                                                                                    [40;1H~                                                                                                                                                                                    [41;1H~                                                                                                                                                                                    [42;1H~                                                                                                                                                                                    [43;1H~                                                                                                                                                                                    [44;1H~                                                                                                                                                                                    [45;1H~                                                                                                                                                                                    [46;1H~                                                                                                                                                                                    [47;1H~                                                                                                                                                                                    [48;1H~                                                                                                                                                                                    [49;1H~                                                                                                                                                                                    [50;1H~                                                                                                                                                                                    [51;1H~                                                                                                                                                                                    [52;1H~                                                                                                                                                                                    [53;1H~                                                                                                                                                                                    [54;1H~                                                                                                                                                                                    [55;1H~                                                                                                                                                                                    [m[56;164H0,0-1[9CAll[1;1H[?25h[?1000l[?1006h[?1002h[?1006l[?1002l[?1006h[?1002h[27m[23m[29m[m[H[2J[?25l[2;1H[94m~                                                                                                                                                                                    [3;1H~                                                                                                                                                                                    [4;1H~                                                                                                                                                                                    [5;1H~                                                                                                                                                                                    [6;1H~                                                                                                                                                                                    [7;1H~                                                                                                                                                                                    [8;1H~                                                                                                                                                                                    [9;1H~                                                                                                                                                                                    [10;1H~                                                                                                                                                                                    [11;1H~                                                                                                                                                                                    [12;1H~                                                                                                                                                                                    [13;1H~                                                                                                                                                                                    [14;1H~                                                                                                                                                                                    [15;1H~                                                                                                                                                                                    [16;1H~                                                                                                                                                                                    [17;1H~                                                                                                                                                                                    [18;1H~                                                                                                                                                                                    [19;1H~                                                                                                                                                                                    [20;1H~                                                                                                                                                                                    [21;1H~                                                                                                                                                                                    [22;1H~                                                                                                                                                                                    [23;1H~                                                                                                                                                                                    [24;1H~                                                                                                                                                                                    [25;1H~                                                                                                                                                                                    [26;1H~                                                                                                                                                                                    [27;1H~                                                                                                                                                                                    [28;1H~                                                                                                                                                                                    [29;1H~                                                                                                                                                                                    [30;1H~                                                                                                                                                                                    [31;1H~                                                                                                                                                                                    [32;1H~                                                                                                                                                                                    [33;1H~                                                                                                                                                                                    [34;1H~                                                                                                                                                                                    [35;1H~                                                                                                                                                                                    [36;1H~                                                                                                                                                                                    [37;1H~                                                                                                                                                                                    [38;1H~                                                                                                                                                                                    [39;1H~                                                                                                                                                                                    [40;1H~                                                                                                                                                                                    [41;1H~                                                                                                                                                                                    [42;1H~                                                                                                                                                                                    [43;1H~                                                                                                                                                                                    [44;1H~                                                                                                                                                                                    [45;1H~                                                                                                                                                                                    [46;1H~                                                                                                                                                                                    [47;1H~                                                                                                                                                                                    [48;1H~                                                                                                                                                                                    [49;1H~                                                                                                                                                                                    [50;1H~                                                                                                                                                                                    [51;1H~                                                                                                                                                                                    [52;1H~                                                                                                                                                                                    [53;1H~                                                                                                                                                                                    [54;1H~                                                                                                                                                                                    [55;1H~                                                                                                                                                                                    [m[56;164H0,0-1[9CAll"WordlyGreetings.cpp" [New][1;1H[?25h[?25l[56;154Hi[1;1H[56;154H [1;1H[56;1H[1m-- INSERT --[m[56;13H[K[56;164H0,1[11CAll[1;1H[?25h[?25l[38;5;81m#include [m[95m<iostream>[m
[96m// main entry point[m[2;20H[K[3;1H[38;5;121mint[m main() {[3;13H[K[4;1H[96m// write a me[m[4;14H[K[4;14H[?25h[?25l[96mssage to console[m
std::cout << [95m"Hello world![m[5;27H[K[6;1H\[6;2H[K[7;1Hn[95m";[m[7;4H[K[8;1H[93mreturn[m [95m0[m;[8;10H[K[56;164H8,10[8;10H[?25h[?25l}[3;12H[46m{[8;10H}[m[56;167H1[8;11H[?25h[?25l[3;12H{[8;10H}[56;164H7,1 [7;1H[?25h[?25l[6;55r[55;1H
[1;56r[6;1H\n[95m";[m[55;1H[94m~                                                                                                                                                                                    [m[56;164H[K[56;164H6,2[11CAll[6;2H[?25h[?25l[56;166H1[6;1H[?25h[?25l[5;55r[55;1H
[1;56r[5;1Hstd::cout << [95m"Hello world![m[38;5;224m\n[m[95m"[m;[55;1H[94m~                                                                                                                                                                                    [m[56;164H[K[56;164H5,27[10CAll[5;27H[?25h[?25l[3;12H[46m{[6;10H}[m[56;164H6,11[6;11H[?25h[?25l:[3;12H{[6;10H}[56;167H2[6;12H[?25h[?25l[6;11H[K[3;12H[46m{[6;10H}[m[56;167H1[6;11H[?25h[56;1H[K[6;10H[?25l[56;154H^[[6;10H[56;154H  [6;11H[56;164H6,10[10CAll[6;10H[?25h[?25l[56;154HW[6;10H[56;154H [6;10H[?25h[?25l[56;154H:[6;10H[56;154H[K[56;1H:[?25hw[?25l"WordlyGreetings.cpp" [New] 6L, 126B written[6;10H[56;164H6,10[10CAll[56;164H[K[56;164H6,10[10CAll[6;10H[?25h[?25l[56;154H:[6;10H[56;1H[K[56;1H:[?25hq[?25l[?1006l[?1002l[?2004l[>4;m[23;2t[23;1t[56;1H[K[56;1H[?1004l[?2004l[?1l>[?25h[>4;m[?1049l[23;0;0tbash-3.2$ g++ WordlyGreetings.cpp 
bash-3.2$ ls
Labs_Assignments	WordlyGreetings.cpp	a.out
bash-3.2$ ./[K[K./ a.out 
bash: ./: is a directory
bash-3.2$ ./a.out 
Hello world!
bash-3.2$ g++ --version
Configured with: --prefix=/Library/Developer/CommandLineTools/usr --with-gxx-include-dir=/Library/Developer/CommandLineTools/SDKs/MacOSX10.15.sdk/usr/include/c++/4.2.1
Apple clang version 12.0.0 (clang-1200.0.32.29)
Target: x86_64-apple-darwin19.6.0
Thread model: posix
InstalledDir: /Library/Developer/CommandLineTools/usr/bin
bash-3.2$ exit

Script done on Wed Sep  7 18:11:25 2022
